111111
100101
1010S1
1100N1
111111
