111111
100101
101001
1i00N1
111111
